I, I, S, I, I, I, I, I, I, I, I, I
I, I, O, I, I, I, O, O, O, I, I, I
I, O, O, O, O, O, I, O, O, O, O, I
I, O, I, I, I, O, I, I, I, I, I, I
I, O, O, O, I, O, O, O, O, I, I, I
I, I, I, I, O, I, I, I, O, I, I, I
I, I, I, I, O, I, O, O, O, O, O, I
I, I, O, I, O, I, I, O, I, O, I, I
I, I, O, O, I, O, O, O, O, O, I, I
I, I, I, I, I, I, O, I, O, O, I, I
I, I, I, I, I, I, O, I, O, I, I, I
I, I, I, I, I, I, O, I, E, I, I, I